###########
#@$      .#
###########
;
####
#@ #
#  #
# $ #
#.  #
####
;